NO textures/checker_north.xpm
SO textures/checker_south.xpm
WE textures/checker_west.xpm
EA textures/checker_east.xpm

F 0,128,0
C 135,206,250

111111111111111
100000000000001
100000000000001
100000001101001
1000N0001101001
100000001001001
100000001101001
100000000000001
111111111111111