NO textures/Bricks_1.xpm
SO textures/Bricks_2.xpm
WE textures/Bricks_3.xpm
EA textures/Bricks_4.xpm

F 133,138,126
C 100,149,237

1111111111111111111
1000001110000000011
1000001110000000011
1000001110000000011
1000000000000001111
1000000000000000001
1000000000000001111
1111111100000000001
100000000000000W001
1011111100000000001
1011111100000000001
1011111100000000001
1011111111111111111
1000000000000000001
1111111111111111001
1111111111111111001
1111111111111111111